Aku	Saya	
Tengah	Tengah
Karo	Dengan
Latar	Halaman
Kanca	Teman
Nganti	 Sampai 
Tekan	Tiba
Sak Jam	Satu Jam
Telat	Terlambat
Sawise	Sesudah
Wis	Sudah
Bubaran	Selesai
Dianyaki	Dimulai
Omah	Rumah
Ngenteni	Menunggu
Klambi	Baju
Rampung	Selesai
Maem	Makan
Mangkat	Berangkat
Mlebu	Masuk	
Didukani	Dipanggil
Suket	Rumput
Dhedhe	Berjemur
Kanggo	Untuk
Ning	Di
Wedhus	Kambing
Mbengok	Berteriak
Ngejak	Mengajak
Enteni	Tunggu
Sedhela	Sebentar
Saurane	Jawabannya
Dalan	Jalan
Ngarep	Depan
Ora	Tidak
Sengaja	Sengaja
Weruh	Tahu 
Sing	Yang
Nemplek	Menempel
Pager	Pagar
Kuwi	Itu
Arep	Akan
Diadani	Diadakan
Adicara	Acara
Iki	Ini
Wiwitane	Mulainya
Saka	Dari
Suwe	Lama
Banget	Sekali
Pitakon	Pertanyaan
Mau	Tadi
Ngerti	Tahu
Melu	Ikut
Apa	Apa
Kowe	Kamu
Duwe	Punya
Pit	Sepeda Angin
Piye	Bagaimana
Sesuk	Besok
Wae	Saja
Mulih	Pulang
Adus	Mandi
Kaya	Seperti
Biyasa	Biasa
Wayah	Waktu
Bengi	Malam	
Sinau	Belajar
Lan	Dan
Terus	Selalu
Banjur	Kemudian	
Matur	Bilang
Nyuwun	Minta	
Anyar	Baru
Durung	Belum	
Dhuwit	Uang
Nggih	Iya
Mboten	Tidak 
Napa-Napa	Apa-apa
Kadingaren	Tumben
Njaluk	Minta
Kula	Saya 
Kangge	Untuk 
Tumut	Ikut
Ngejeng	Depan
Ngene	Begini
Pawon	Dapur
Kae	Itu
Ana	Ada
Kebo	Kerbau
Tinggalan	Peninggalan
Diresiki	Dibersihkan 
Dikumbah	Dicuci 
Nanging	Tapi
Sampun	Sudah
Lawas	Lama
Teyengen	Berkarat 
Malih	Lagi
Rasah	Tidak Usah
Kahanan	Keadaan	
Sakanan	Seadanya

